Year,School,Conf,Rank,G,W,L,Opp_Fum,Opp_Int,Opp_TO,Fum,Int,TO,Margin/G
2012,Oregon,Pac-12,1,13,12,1,14,26,40,10,9,19,1.62
2012,Boise St.,Mountain West,2,13,11,2,18,18,36,9,7,16,1.54
2012,Kansas St.,Big 12,3,13,11,2,13,18,31,3,9,12,1.46
2012,Kent State,MAC,4,14,11,3,15,23,38,7,11,18,1.43
2012,LSU,SEC,5,13,10,3,15,18,33,10,7,17,1.23
2012,Mississippi St.,SEC,5,13,8,5,14,19,33,7,10,17,1.23
2012,Florida,SEC,7,13,11,2,10,20,30,10,5,15,1.15
2012,Fresno St.,Mountain West,7,13,9,4,13,22,35,12,8,20,1.15
2012,Ohio,MAC,7,13,9,4,12,13,25,5,5,10,1.15
2012,Louisiana Tech,WAC,10,12,9,3,16,10,26,8,5,13,1.08
2012,Northwestern,Big Ten,11,13,10,3,16,13,29,8,7,15,1.08
2012,SMU,C-USA,11,13,7,6,16,21,37,8,15,23,1.08
2012,Alabama,SEC,13,14,13,1,11,18,29,12,3,15,1
2012,Iowa,Big Ten,13,12,4,8,13,10,23,3,8,11,1
2012,Pittsburgh,AAC,15,13,6,7,7,15,22,7,3,10,0.92
2012,Central Florida,C-USA,16,14,10,4,16,11,27,8,7,15,0.86
2012,Louisville,AAC,17,13,11,2,13,11,24,5,8,13,0.85
2012,New Mexico,Mountain West,17,13,4,9,14,11,25,10,4,14,0.85
2012,Middle Tennessee,Sun Belt,19,12,8,4,16,12,28,10,8,18,0.83
2012,Georgia,SEC,20,14,12,2,17,13,30,8,11,19,0.79
2012,Rutgers,AAC,21,13,9,4,14,18,32,6,16,22,0.77
2012,Penn State,Big Ten,22,12,8,4,12,10,22,8,5,13,0.75
2012,Arkansas St.,Sun Belt,23,13,10,3,10,13,23,9,5,14,0.69
2012,Cincinnati,AAC,23,13,10,3,12,16,28,8,11,19,0.69
2012,Wake Forest,ACC,25,12,5,7,12,11,23,8,7,15,0.67
2012,Stanford,Pac-12,26,14,12,2,12,15,27,8,10,18,0.64
2012,Notre Dame,FBS Independent,27,13,12,1,7,16,23,7,8,15,0.62
2012,Oregon St.,Pac-12,27,13,9,4,11,20,31,7,16,23,0.62
2012,San Jose St.,WAC,27,13,11,2,17,15,32,15,9,24,0.62
2012,Miami (FL),FL ,30,12,7,5,11,11,22,8,7,15,0.58
2012,North Carolina,ACC,30,12,8,4,9,16,25,11,7,18,0.58
2012,Wyoming,Mountain West,30,12,4,8,14,6,20,5,8,13,0.58
2012,UL Monroe,Sun Belt,33,13,8,5,10,16,26,4,15,19,0.54
2012,Toledo,MAC,33,13,9,4,10,17,27,9,11,20,0.54
2012,West Virginia,Big 12,33,13,7,6,10,10,20,6,7,13,0.54
2012,Northern Illinois,MAC,36,14,12,2,12,15,27,14,6,20,0.5
2012,UCLA,Pac-12,36,14,9,5,17,15,32,14,11,25,0.5
2012,Arizona St.,Pac-12,38,13,8,5,9,21,30,12,12,24,0.46
2012,Rice,C-USA,39,13,7,6,16,11,27,17,5,22,0.38
2012,Texas,Big 12,39,13,9,4,6,15,21,5,11,16,0.38
2012,Washington,Pac-12,39,13,7,6,16,17,33,14,14,28,0.38
2012,Utah,Pac-12,42,12,5,7,14,8,22,9,9,18,0.33
2012,Bowling Green,MAC,43,13,8,5,12,10,22,5,13,18,0.31
2012,South Carolina,SEC,43,13,11,2,9,15,24,11,9,20,0.31
2012,Georgia Tech,ACC,45,14,7,7,9,16,25,13,8,21,0.29
2012,Ohio St.,Big Ten,46,12,12,0,7,14,21,11,7,18,0.25
2012,TCU,Big 12,47,13,7,6,11,21,32,17,12,29,0.23
2012,Tulsa,C-USA,48,14,11,3,15,12,27,11,13,24,0.21
2012,Wisconsin,Big Ten,48,14,8,6,7,8,15,6,6,12,0.21
2012,Baylor,Big 12,50,13,8,5,7,18,25,10,13,23,0.15
2012,Central Michigan,MAC,50,13,7,6,5,13,18,7,9,16,0.15
2012,Clemson,ACC,50,13,11,2,10,13,23,7,14,21,0.15
2012,Duke,ACC,50,13,6,7,12,11,23,9,12,21,0.15
2012,Michigan St.,Big Ten,50,13,7,6,6,14,20,8,10,18,0.15
2012,Missouri,SEC,55,12,5,7,16,7,23,8,14,22,0.08
2012,North Texas,Sun Belt,55,12,4,8,8,11,19,4,14,18,0.08
2012,San Diego St.,Mountain West,57,13,9,4,12,14,26,14,11,25,0.08
2012,East Carolina,C-USA,58,13,8,5,12,10,22,8,14,22,0
2012,Iowa St.,Big 12,58,13,6,7,12,14,26,9,17,26,0
2012,Navy,Independent,58,13,8,5,11,8,19,14,5,19,0
2012,Oklahoma St.,Big 12,58,13,8,5,11,11,22,6,16,22,0
2012,Vanderbilt,SEC,58,13,9,4,7,11,18,13,5,18,0
2012,Arizona,Pac-12,63,13,8,5,15,12,27,13,15,28,-0.08
2012,Louisiana,Sun Belt,63,13,9,4,8,13,21,13,9,22,-0.08
2012,Ole Miss,SEC,63,13,7,6,13,15,28,11,18,29,-0.08
2012,Utah St.,WAC,63,13,11,2,6,14,20,11,10,21,-0.08
2012,Western Kentucky,Sun Belt,63,13,7,6,10,13,23,12,12,24,-0.08
2012,Memphis,C-USA,68,12,4,8,15,8,23,21,3,24,-0.08
2012,Minnesota,Big Ten,69,13,6,7,7,13,20,7,15,22,-0.15
2012,Purdue,Big Ten,69,13,6,7,11,14,25,13,14,27,-0.15
2012,USC,Pac-12,69,13,7,6,13,19,32,14,20,34,-0.15
2012,Syracuse,AAC,69,13,8,5,11,9,20,12,10,22,-0.15
2012,Florida Atlantic,Sun Belt,73,12,3,9,9,8,17,13,6,19,-0.17
2012,Marshall,C-USA,73,12,5,7,9,9,18,8,12,20,-0.17
2012,Temple,AAC,75,11,4,7,13,4,17,13,6,19,-0.18
2012,BYU,Independent,76,13,8,5,10,12,22,8,17,25,-0.23
2012,Ball St.,MAC,76,13,9,4,7,7,14,7,10,17,-0.23
2012,Indiana,Big Ten,78,12,4,8,6,7,13,3,13,16,-0.25
2012,Kansas,Big 12,78,12,1,11,9,11,20,10,13,23,-0.25
2012,Nevada,Mountain West,80,13,7,6,12,6,18,12,10,22,-0.31
2012,Oklahoma,Big 12,80,13,10,3,3,13,16,9,11,20,-0.31
2012,Florida Intl,Sun Belt,82,12,3,9,8,10,18,16,6,22,-0.33
2012,Houston,C-USA,82,12,5,7,12,19,31,15,20,35,-0.33
2012,Kentucky,SEC,82,12,2,10,7,5,12,6,10,16,-0.33
2012,UTEP,C-USA,82,12,3,9,12,7,19,10,13,23,-0.33
2012,Texas A&M,SEC,86,13,11,2,4,12,16,11,10,21,-0.38
2012,Virginia Tech,ACC,86,13,7,6,8,13,21,9,17,26,-0.38
2012,Boston College,ACC,88,12,2,10,9,10,19,11,13,24,-0.42
2012,Colorado St.,Mountain West,88,12,4,8,14,7,21,11,15,26,-0.42
2012,Eastern Michigan,MAC,88,12,2,10,9,7,16,6,15,21,-0.42
2012,Miami (FL),OH ,88,12,7,5,2,12,14,7,12,19,-0.42
2012,Tennessee,SEC,88,12,5,7,5,12,17,8,14,22,-0.42
2012,Florida St.,ACC,93,14,12,2,10,11,21,17,10,27,-0.43
2012,UNLV,Mountain West,94,13,2,11,8,9,17,6,17,23,-0.46
2012,Buffalo,MAC,95,12,4,8,3,13,16,12,10,22,-0.5
2012,California,Pac-12,96,12,3,9,9,14,23,17,13,30,-0.58
2012,Troy,Sun Belt,96,12,5,7,14,6,20,15,12,27,-0.58
2012,Army,Independent,98,12,2,10,7,7,14,20,2,22,-0.67
2012,Michigan,Big Ten,99,13,8,5,11,7,18,8,19,27,-0.69
2012,NC State,ACC,99,13,7,6,8,16,24,16,17,33,-0.69
2012,Tulane,C-USA,101,12,2,10,9,15,24,13,20,33,-0.75
2012,UAB,C-USA,101,12,3,9,12,6,18,14,13,27,-0.75
2012,Washington St.,Pac-12,101,12,3,9,6,15,21,9,21,30,-0.75
2012,Maryland,ACC,104,12,4,8,16,4,20,18,12,30,-0.83
2012,Nebraska,Big Ten,105,14,10,4,10,13,23,22,13,35,-0.86
2012,Air Force,Mountain West,106,13,6,7,8,8,16,21,8,29,-1
2012,Auburn,SEC,106,12,3,9,11,2,13,10,15,25,-1
2012,Illinois,Big Ten,106,12,2,10,11,7,18,16,14,30,-1
2012,Texas Tech,Big 12,106,13,8,5,3,8,11,8,16,24,-1
2012,Akron,MAC,110,12,1,11,8,5,13,9,18,27,-1.17
2012,Connecticut,AAC,110,12,5,7,6,6,12,8,18,26,-1.17
2012,Hawaii,Mountain West,110,12,3,9,10,9,19,20,13,33,-1.17
2012,Virginia,ACC,110,12,4,8,8,4,12,11,15,26,-1.17
2012,Western Michigan,MAC,110,12,4,8,9,8,17,10,21,31,-1.17
2012,Southern Miss,C-USA,115,12,0,12,7,5,12,15,13,28,-1.33
2012,Idaho,WAC,116,12,1,11,13,9,22,17,22,39,-1.42
2012,New Mexico State,WAC,117,12,1,11,5,4,9,16,11,27,-1.5
2012,Arkansas,SEC,118,12,4,8,6,6,12,15,16,31,-1.58
2012,Colorado,Pac-12,118,12,1,11,12,3,15,15,19,34,-1.58
2012,South Florida,AAC,118,12,3,9,7,2,9,13,15,28,-1.58
